############################..##############################
############################################################
##########################.#..##.###########################
#####################.##......##############################
#######..##########..###......#######..##########..#########
###############.###..###......###.###..#####################
##.####..#..#.....#..#........#...###..#..#..#..#..#..##.###
.###.##.#..#..#...#...............##........#..#..#..####.##
###############.###...##..........###..#####################
###############.###...........#...###..#####################
###.###########.###...............###..######.##############
###############.#.#...............###..##.##################
..................#...............#................#..#...##
###.###..############............############.###..#########
###.###..############............############.###..#########
#...###..#..##.#..#..............##.#..#..#...###..#..##.###
......#.........................................#.....#...##
.##..#.....#..#..##.#############.##..#..#..#..#.....####.##
#######################################
